10
20
9
3
3
4
67
|-----||||||||||||-|
|-|||-|------------|
|---|-|-||||||||||-|
|||||-|-|||||------|
--------|-----||||||
-||||||||||-||||---|
-|-|||-----------|-|
-|---|||||||||||-|||
-|-|---------------|
||||||||||||||||||||