12
35
7
2
4
24
65
||||||||||||||||||||||||||||||||||||
|-----|-|||-|||||||-----------|-||-|
|-|||||-||--|-|-----|-||||-||-|----|
|---------|-----|||||-|--|--|-||||-|
|||||||||---|||||--|--||----|||-||-|
|-------|---------|||-|||||||----|-|
|-|||-|-|||||-||-------||-----||-|-|
|-|-|-|--------||||||-|||-||||||||-|
|-|---|-|--------------------------|
|-|||||-||||||||||||||||||||-|||||||
|----------------------------------|
||||||||||||||||||||||||||||||||||||